1111111111111
1001000000C01
100P001111001
10001100E0001
1111111111111