1111111111111
100100C000C01
10P0C01111101
10001100E0001
1111111111111