1111111111111111111111111
10E0000C0000000C0000000C1
101C010100101C00111110111
101011001011111000C010001
1010C101C01C0000101001001
101P110C10111110C00010001
111PPPPPPPPPPPPPPPPPPPPP1
1PP1111111PPPPPPPPPPPPPP1
1111111111111111111111111