1111111111111111111111111
1E10000C000000000000000C1
101C010100101C00111111111
101111001011111000C010001
1010C101001C0000101001001
1010110C10111110000010001
1010010100100000101001001
1P0000C00C000000000C10001
1111111111111111111111111