1111111111111111111111111
1E10000C0000000C0000000C1
101C010100101C00111110111
101111001011111000C010001
1010C101C01C0000101001001
1010110C10111110C00010001
1010010100100000101001001
1P0000C00C00C00000001C0C1
1111111111111111111111111